###########
#         #
#  X  P   #
#   #######
#         #
#         #
######    #
# O       #
#         #
###########
